{
  "id": "gauntlet",
  "name": "Level 3 — The Gauntlet",
  "hint": "Rockies patrol faster lanes than roundels—watch their bounce patterns before crossing.",
  "map": [
    "####################",
    "#...*.......*......#",
    "#..................#",
    "#.##.........##....#",
    "#.*.r.......r..*...#",
    "#.##.........##....#",
    "#..................#",
    "#...b..............#",
    "#...*.......*......#",
    "#..............v...#",
    "#..................#",
    "#....*...r....*....#",
    "#..................#",
    "#.......P..*.....E.#",
    "####################"
  ]
}

