{
  "id": "crossroads",
  "name": "Level 2 — Crossroads",
  "hint": "This route is spacious, but the roundel will punish hesitation near the choke points.",
  "map": [
    "####################",
    "#....*.......*.....#",
    "#..................#",
    "#..####......####..#",
    "#..#...........#...#",
    "#..#...s.......#...#",
    "#..#...........#...#",
    "#......r...........#",
    "#..................#",
    "#..#...........#...#",
    "#..#.......s...#...#",
    "#..####......####..#",
    "#....*....P....E...#",
    "#..................#",
    "####################"
  ]
}

