{
  "id": "garden",
  "name": "Level 1 — The Garden",
  "hint": "Warm up by collecting the easy gems, then lure the roundels into open space.",
  "map": [
    "####################",
    "#..................#",
    "#.....*.....*......#",
    "#..................#",
    "#..###.......###...#",
    "#..#...........#...#",
    "#..#....r......#...#",
    "#..#...........#...#",
    "#..###.......###...#",
    "#..................#",
    "#.r....*....*......#",
    "#..................#",
    "#.*.*.*...*.*.*....#",
    "#.......P....E.....#",
    "####################"
  ]
}

