{
  "id": "maelstrom",
  "name": "Level 6 — Maelstrom",
  "hint": "Everything moves here. Read the room, then dash through the brief safe windows.",
  "map": [
    "####################",
    "#*.....r....*....v.#",
    "#..###....###......#",
    "#..#..........#....#",
    "#..#..s..r.....#.*.#",
    "#..###....###......#",
    "#......b...........#",
    "#.*................#",
    "#........####......#",
    "#...r....#..#...r..#",
    "#........####......#",
    "#....*.............#",
    "#..P......*.....E..#",
    "#.............v....#",
    "####################"
  ]
}

