{
  "id": "caverns",
  "name": "Level 4 — Echo Caverns",
  "hint": "The caverns split movement into narrow vertical lanes—watch the patrolling rockies before committing.",
  "map": [
    "####################",
    "#..*......#....*...#",
    "#.####..#.#..####..#",
    "#......r#.#r.......#",
    "#.####..#.#..####..#",
    "#..*....#.#....*...#",
    "#......#.#.........#",
    "#...b...#.#....v...#",
    "#......#.#.........#",
    "#..*....#.#....*...#",
    "#.####..#.#..####..#",
    "#..................#",
    "#....P.......E.....#",
    "#..................#",
    "####################"
  ]
}

