{
  "id": "fortress",
  "name": "Level 2 — The Fortress",
  "hint": "Push the soft blocks only when you need space—the fortress punishes careless shoves.",
  "map": [
    "####################",
    "#.*..............*.#",
    "#.#.##.......##.#..#",
    "#.#.r#.......#..#..#",
    "#.#..#.......#..#..#",
    "#.#..#.*.....#..#..#",
    "#.#.##.......##.#..#",
    "#..................#",
    "#.*.s.r......r.s.*.#",
    "#..................#",
    "#..*...*...*...r...#",
    "#..................#",
    "#.s....*....*...s..#",
    "#.......P.......E..#",
    "####################"
  ]
}

